# XSB
# Simplified representation
write('Hello, World!'), nl.
